####################
#                  #
# $                #
#                  #
################   #
##########         #
#####    # ####### #
####  ##   ####### #
####        ###### #
####     @    #### #
####       ## #### #
####  ##   ## #### #
##         ##  *   #
##   ##    #########
##   ##  * #########
##   ##   ##########
##       #####     #
## ##########    E #
##                 #
####################